ABAR|ABARTH
AC|AC (GREAT BRITAIN)
ACAD|ACADIAN (GM OF CANADA)
ACUR|ACURA
ADET|ADETTE
ADVA|ADVANCE MFG CO
AEAG|AMERICAN EAGLE MOTORCYLE
AERA|AEROCAR
AETA|AETA
AIRO|AIR-O-MOTOR HOME
ALFA|ALFA ROMEO
ALLA|ALLARD
ALLE|ALLEGRO MOTOR HOME
ALLF|ALLISON'S FIBERGLASS MFG
ALLS|ALL STATE
ALMA|ALMA
ALPI|ALPINE
ALTA|ALTA
ALVI|ALVIS
AMER|AMC
AMF|AMF LAWN & GARDEN DIV
AMGN|AMGN (MAKES MODEL HUMMER)
AMPH|AMPHICAR
AMTC|AMERICAN TRANSPRTATION CO
APOL|APOLLO HOMES
APRI|APRILIA MOTORCYCLES
ARCA|ARCTIC CAT (MC/ATV)
ARCC|ARCTIC CAT (SNOWMOBILE)
ARGO|ARGONAUT STATE LIMOUSINE
ARIS|ARISTOCRAT MOTOR HOME
ARIT|ARISTA
ARMS|ARMSTRONG SIDDELEY
ARNO|ARNOLT-BRISTOL
ARRO|ARROW
ARSC|ASCORT
ASA|ASA
ASHL|ASHLEY
ASTO|ASTON MARTIN
ASTR|ASTRO MOBILE HOMES MFG
ASUN|ASUNA
ASVE|ASSEMBLED VEHICLE
ATK|ATK AMERICA INC
ATLS|ATLAS HOIST & BODY INC
AUBU|AUBURN
AUDI|AUDI
AUHE|AUSTIN-HEALY
AUKR|AUTOKRAFT
AURR|AURORA
AUST|AUSTIN
AUTA|AUTOBIANCHI
AUTB|AUTOBLEU
AUTI|AUTO TRAILER CO
AUTO|AUTOCAR
AUTR|AUTOCARRIER AND A.C.
AUTT|AUTOMATIC DRILLING MACHIN
AVA|AVA TRAVEL TRAILER
AVAL|AVAILABLE
AVCO|AVCO CORPORATION
AVEN|AVENGER
AVIA|AVIA
AVTI|AVANTI
AZTC|AZTEC PRODUCTS INC
BANK|BANKHEAD WELDING SERVICE
BANN|BANNER
BARR|BARRET
BEAD|BEARDMORE
BEAM|BEACH-CRAFT MOTOR HOMES
BEBE|BEBE
BECK|BECKER, CHARLES H
BEDF|BEDFORD
BEEH|BEECHWOOD MOTOR HOME
BEJE|BEIJING JEEP GANG STAR
BENT|BENTLEY
BERG|BERGANTINE
BERK|BERKLEY
BERO|BERTONE
BESA|BESASIE AUTOMOBILE CO
BGDG|BIG DOG MOTORCYCLES,LLC.
BIGT|BIG TEX TRAILER CO.,INC.
BITT|BITTER
BIZZ|BIZZARRINI
BLUB|BLUE BIRD BODY CO
BMBR|RECREATIONAL PRODUCTS GRO
BMC|BMC
BMW|BMW
BNTM|BANTAM
BOAS|BOA-SKI ALSPORT LTD.
BOAT|BOATEL SKI
BOBB|BOBBI-KAR
BOCA|BOCAR
BOMB|BOMBARDIER (ATV/MC)
BOMR|BOMBARDIER INC.
BOND|BOND
BORG|BORGWARD
BRAD|BRANDT TRAILERS
BRAS|BRASINCA
BRDL|BRADLEY GT
BREM|BREMEN
BRIC|BRICKLIN
BRID|BRIDGESTONE
BRIS|BRISTOL
BROC|BROCKWAY
BROS|BROS. DIV
BROU|BROUGHAM INDUSTRIES, INC
BROW|BROWN
BRSH|BRUSH
BRUZ|BRUTANZA
BSA|BSA
BUEL|BUELL
BUG|BUG
BUGA|BUGATTI
BUIC|BUICK
BULT|BULTACO
BUSP|BUFFALO-SPRINGFIELD
BUTT|BUTTERFIELD MUSKETEER
BZEL|B & Z ELECTRIC CAR CO.
CABA|CABANA MOTOR HOME
CADI|CADILLAC
CAGI|CAGIVA(MC-MFG.BY MV AGUST
CALU|CALUMET COACH
CAP|CAPRI
CASE|CASE, J I
CAT|CATERPILLAR TRACTOR
CCC|CCC
CHAI|CHAIKA
CHAM|CHAMPION
CHEC|CHECKER
CHEO|CHEROKEE CAMPER
CHEV|CHEVROLET
CHIN|CHING-KAN-SHAN
CHNO|CHINOOK
CHOC|CHRYSLER OUTBOARD CORPORA
CHPR|CHAPARRAL
CHRY|CHRYSLER
CHVL|CHEVALLERO MOTOR HOME
CISI|CISITALIA
CITI|CITICAR (ELECTRIC CAR)
CITR|CITROEN
CLAC|CLASSIC ROADSTERS, LTD.
CLAI|CLASSIC MOTOR CARRIAGES
CLAR|CLARK EQUIPMENT
CLEN|CLENET
CLUA|CLUA
COAH|COACHMAN
COBR|COBRA
COLT|COLT
COMV|COMMUTER
CONC|CONCORD
CONN|CONNAUGHT
CONO|CONDOR COACH
CONS|CONTESSA
CONU|CONSULIER
COOP|COOPER
CORB|CORBITT
CORD|CORD
COTZ|CORTEZ MOTOR HOME
CRAF|CRAFTSMAN - TRUCK
CRAN|CRANE & HOIST OPERATIONS
CREL|CORBIN MOTORS
CRFT|CRAFTSMAN - FARM EQUIP
CROF|CROFTON CUB
CROS|CROSLEY
CRUI|CRUISAIRE MOTOR CORP
CSHM|CUSHMAN - SNOWMOBILE
CUBS|CUBSTER
CUNN|CUNNINGHAM
CUSH|CUSHMAN
DAEW|DAEWOO
DAF|DAF
DAIH|DAIHATSU
DAIM|DAIMLER
DAIN|D & A VEHICLES
DATS|DATSUN
DAUP|DAUPHIN
DAVI|DAVIS
DAYO|DAYTONA
DB|D.B.
DEBO|DEBONAIR
DECO|DECOURVILLE
DEEP|DEEP SANDERSON
DEER|JOHN DEERE
DELL|DELLOW
DELO|DE LOREAN
DENZ|DENZEL
DESO|DESOTO
DETO|DETOMASO
DIAH|DIAHATSU
DIAR|DIAMOND RIO
DIAT|DIAMOND T
DITE|DI TELLA
DIVA|DIVA
DIVC|DIVCO
DKW|DKW
DMHC|DMHC (MAKES CHIEF)
DODE|DODE (MAKES WOODCRAFT)
DODG|DODGE
DONG|DONG FENG (EAST WIND)
DORS|DORSEY TRAILERS
DUCA|DUCATI
DUEL|DUEL
DUES|DUESENBERG
DUPL|DUPLEX TRUCK DIV
DURA|DURANT
EADU|EAST MANUFACTURING CO
EAGB|EAGER BEAVER TRAILER
EAGI|EAGLE INTERNATIONAL
EAGL|EAGLE TRAILER MFG
EDSE|EDSEL
EGIL|EAGLE
EGLE|EAGLE - MOTORCYCLE
ELDO|EL DORADO
ELEC|ELEC-TRAC
ELGN|ELGIN SWEEPER COMPANY
ELVA|ELVA
ELVC|ELECTRIC VEHICLE
EMW|EMW
ENCR|ENCORE VEHICLES, INC.
ENGF|ENGLISH FORD (BRITISH)
ENVY|ENVOY
ENZM|ENZMANN
ERSK|ERSKINE
ESHL|ESHELMAN SPORTABOUT
ESSE|ESSEX
EUCL|EUCLID
EVRY|EVERYBODY'S MOTOR CAR
EXCL|EXCALIBUR
EXHE|EXCELSIOR-HENDERSON (MC)
FACE|FACEL-VEGA
FACL|FACELLIA
FAIR|FAIRTHORPE
FALC|FALCON (BRITISH)
FARG|FARGO
FEDL|FEDERAL
FELB|FELBER
FEMC|FELDMAN ENGINEERING & MFG
FERR|FERRARI
FIAA|FIAT-ABARTH
FIAT|FIAT
FIBE|FIBERFAB, INC.
FIST|FIESTA
FLEX|FIXIBLE
FMC|FMC
FNM|FNM
FONA|FONTAINE TRAILER COMPANY
FONS|FONTAINE SPECIALIZED TRLR
FORD|FORD
FRAI|FRANKLIN COACH
FRAN|FRANKLIN
FRAZ|FRAZIER
FRED|FREDERICK-WILLYS
FREF|FRENCH FORD
FRHT|FREIGHTLINER
FRIS|FRISKY
FRNA|FRAZER-NASH
FRRV|FOREST RIVER, INC. (TL)
FRTV|FORETRAVEL
FRUE|FRUEHAUF
FTWD|FLEETWOOD
FWD|FWD
GALI|GALION
GAZ|GAZ
GBCO|GILSON BROTHERS
GDAN|GREAT DANE TRAILERS
GEO|GEO
GEOR|GEORGIE BOY
GIAN|GIANNINI
GIGI|GIGI INDUSTRIES
GILB|GILBERN
GIND|GINDY MFG
GINE|GINETTA
GITA|GITANE
GLAS|GLAS
GLBL|GLOBAL ELECTRIC MOTORCARS
GLSC|GLASSIC
GM|GENERAL MOTORS
GMC|GENERAL MOTORS CORP
GOKT|GO KART
GOLI|GOLIATH
GORD|GORDON
GRAC|GRACIELA
GRAD|GRADALL
GRAH|GRAHAM
GRAP|GRAHAM-PAIGE
GRES|GREAT ESCAPE
GRIF|GRIFFITH
GRUM|GRUMMAN
GSM|GSM
GWM|GULF & WESTERN
GZL|GAZELL
HACK|HACKNEY & SONS
HAHN|HAHN
HAUI|HAULMARK INDUSTRIES, INC.
HD|AMF
HDMC|HARLEY-DAVIDSON
HEIL|HEIL TRAILER INTL. INC.
HEIN|HEINKEL
HEND|HENDRICKSON MANUFACTURING
HENR|HENRY J
HICK|HICKEY TRAIL-BLAZER
HILL|HILLMAN
HIND|HINDUSTAN
HINO|HINO
HOBB|HOBBS TRAILERS
HOLD|HOLDEN
HOND|HONDA
HONG|HONGKI OR HONG-CHI
HORC|HORCH LIMOUSINE
HORT|HORNET FLATBED TRAILER
HOTC|HOTCHKISS
HOUG|HOUGH BROTHERS
HRG|HRG
HRTI|HERTER'S
HUDS|HUDSON
HUMB|HUMBER
HUME|HUMBEE SURREY
HUMM|HUMMER
HUPM|HUPMOBILE
HURU|HUSTLER-RUSTLER
HUSA|HUSABERG MOTOR AB
HUSQ|HUSQVARNA
HYND|HYUNDAI MARCIA
HYST|HYSTER
HYTR|HYUNDAI TRANSLEAD TRAILER
HYUN|HYUNDAI
IAME|I. A. M. E.
ICRP|IC CORPORATION
IKA|I. K. A.
IMPB|I. M. P. (U.S.)
IMPE|IMPERIAL
IND|INDIAN
INDI|INDIANA
INFI|INFINITI
INME|INTERMECCANICA
INNO|INNOCENTI
INTL|INTERNATIONAL
ISET|ISETTA
ISLA|ISLANDER MOTOR HOME
ISO|ISO
ISU|ISUZU
ITAF|ITALIAN FORD
ITAI|ITALIA
ITAS|ITASCA MOTOR HOMES
IVEC|IVECO TRUCKS OF N AMERICA
JACC|JAC-TRAC
JACO|JACOBSEN MANUFACTURING
JAGU|JAGUAR
JAWA|JAWA
JAY|JAYCO
JEEP|JEEP
JENS|JENSEN
JETM|JETMOBILE
JOWE|JOWETT
KAIS|KAISER
KAKI|KAMP KING UTOPIAN
KALY|KALYN COMPANY
KAWK|KAWASAKI (JAPAN)
KENS|KENSINGTON MOTOR
KENT|KENTUCKY MFG
KIA|KIA MOTORS CORP
KIMI|KING MIDGET
KMCU|KAWASAKI/SNO*JET-SNOWMOBI
KOME|KOMETIK
KTM|KTM
KURT|KURTIS KRAFT
KW|KENWORTH
KWDT|KW DART
LADA|LADA
LAFY|LAFAYETTE MOTOR HOME
LAGO|LAGONDA
LALL|LASALLE
LAMB|LAMBRETTA
LAMO|LAMBORGHINI
LAN|LANE FLATBED TRAILER
LANC|LANCHESTER
LARV|LARVIN
LASA|LASALLE (TRAILERS)
LASE|LASER
LBT|LBT INC (DIV.FRUEHAUF COR
LEAF|LEA-FRANCIS
LETO|LETOURMEAU, R G
LEWI|LEWIS-SHEPARD
LEXS|LEXUS
LFZA|LAFORZA
LINC|LINCOLN
LIND|LINDE
LIOL|LIONAL ENTERPRISES
LLOY|LLOYD
LNCI|LANCIA
LNDR|LNDR (MAKES RANGE ROVER)
LOCO|LOCOMOBILE
LODA|LODAL
LOLA|LOLA
LOND|LONDON MOTORS
LOOD|LOODCRAFT
LOTU|LOTUS
LSKP|LORI ENGINEERING
LUFK|LUFKIN TRAILERS
MACK|MACK
MAHA|MAMON HARRINGTON
MALR|MALLARD
MARC|MARCOS
MARM|MARMON
MASE|MASERATI
MASS|MASSEY-FERGUSEN
MATA|MATRA
MAV|MAVERICK
MAXI|MAXIM
MAXL|MAXWELL
MAZD|MAZDA
MBM|M.B.M.
MCIN|MCI
MDNA|MODENA
MEAN|MEAN
MERC|MERCURY
MERH|MERH COACH CORP.
MERK|MERKUR
MERZ|MERCEDES BENZ
MESS|MESSERSCHMITT
METE|METEOR
METR|METROPOLITAN
MG|MG
MICC|MICRO CONCEPT CARS
MIDA|MID-ATLANTIC HOMES
MIDS|MIDAS INTERNATIONAL
MIFU|MIFU (FUSO TRUCK OF AMER)
MIKA|MIKASA
MIKR|MIKRUS
MILL|MILLER TRAILERS INC.
MIST|MISTRAL
MITS|MITSUBISHI
MKMH|MK 5-1400 MOTOR HOME
MNNI|MINI
MNTA|MANTA
MODE|MODEL A/T REPRO CORP
MOGU|MOTO GUZZI
MONA|MONARCH
MONC|MONC -DAYTONA MOBILE HOME
MONG|MONTAGNAIS
MONN|MONON TRAILER DIV.
MORE|MORETTI
MORG|MORGAN
MORR|MORRIS
MOSK|MOSTOVITCH
MOWA|MONTGOMERY WARD
MRCU|MERCURY (SNOWMOBILE)
MSFI|MASSEY-FERGUSON
MTD|MTD PRODUCTS, INC.
MTPI|COLUMBIA (SNOWMOBILE)
MUNT|MUNTZ
MURE|MURENA
MVAU|MV AGUSTA
MZMA|MZMA
NAHE|NASH-HEALY
NAMO|NAMCO INDUSTRIES
NARD|NARDI-DANESE
NASH|NASH
NDMC|NISSAN DIESEL MOTOR CO.
NECK|NECKAR
NISS|NISSAN
NORH|NORTHWEST ENGINEERING
NORS|NORSE TRAILER
NORT|NORTON
NRTS|NORTHWAY
NSU|NSU
NSUF|NSU-FIAT
OAKL|OAKLAND
OCCH|ORANGE COUNTY CHOPPERS
OCKE|OCKELBO INDUSTRY AB
ODGL|ONTARIO DRIVE & GEAR
OGLE|OGLE
OHTA|OHTA
OLDS|OLDSMOBILE
OLIV|OLIVER
OLSO|OLSON
OMEG|OMEGA (ITALIAN)
OPEL|OPEL
OPER|OPEN ROADSTERS OF TEXAS
ORIG|ORIGINAL EQUIPMENT
OSCA|OSCA
OSHK|OSHKOSH MOTOR TRUCK
OSI|OSI
OSTD|OSHKOSH TRAILER DIVISION
OTH|OTHER
OTOS|OTOSAN
OTPE|OUTDOOR POWER EQUIPMENT
OUTM|OUTBOARD MARINE
OVER|OVERLAND
PACK|PACKARD
PALL|PALLISER (RACING CAR)
PAMR|PACE AMERICAN, INC.
PANE|PANTHER WESTWINDS
PANH|PANHARD
PANZ|PANOZ
PASS|PASSPORT
PAUG|PAUGHCO, INC.
PEAC|PEACE
PEEL|PEEL
PEER|PEERLESS
PEGA|PEGASO
PERC|PERCH
PETM|PETTIBONE
PEUG|PEUGEOT
PHOE|PHOENIX
PINE|PINES TRAILER
PINI|PINIFARINA
PLAY|PLAYBOY
PLRN|POLORON
PLYC|PLAYCAT INDUSTRIES
PLYM|PLYMOUTH
POIR|POIRIER
POLB|POLAR BEAR
POLS|POLARIS
PONI|PONTIAC-CANADIAN
PONT|PONTIAC
PORS|PORSCHE
PRAI|PRAIRIE SCHOONER
PRCA|PIERCE ARROW
PRMO|PRINCE MOTORS
PROG|PROGRESS
PTRB|PETERBILT-MOTORS
PTV|PTV
PUCH|PUCH
QINJ|QIANJIANG
RAID|RAIDER
RAMB|RAMBLER
RAMS|RAMSES
RAVE|RAVENS-METAL PRODUCTS, IN
RCMH|RC MOTOR HOME
RDER|RAIDER (MOTORCYCLE)
REDI|REDI-GO TRAVELER
RELA|RELIANT
RENA|RENAULT
REO|REO
REXM|REX MOBILE HOMES
RILE|RILEY
RIND|RICH INDUSTRIES
RIVS|RIVERSIDE
ROAM|ROAMINGHOME
ROAR|ROADMASTER RAIL,INC.
ROCH|ROCHDALE
ROK|ROCKNE
ROKW|ROCKWOOD
ROL|ROLLS-ROYCE
ROLF|ROLL-O-FLEX, LTD.
ROOT|ROOTES
ROV|ROVER
RPII|RUPP INDUSTRIES
RYCS|RYCSA
SAA|SAAB
SABE|SABRE
SABR|SABRA
SANG|SANGYONG CM600S
SCAN|SCANIA
SCIO|SCION
SCRP|SCORPION
SEAF|SEAGRAVE FIRE APPARTUS
SEAR|SEARS, ROEBUCK & CO
SEAT|SEAT
SERA|SERA
SHAS|SHASTA MOTOR HOME
SHEB|SHELBY AMERICAN
SIAT|SIATA
SILA|SILA AUTORETTA
SILV|SILVER STREAK
SIM|SIMCA
SIN|SINGER
SKIR|SKIROULE
SKMD|SKYLINE MOTORIZED
SKOD|SKODA
SMRT|SMART VEHICLES
SNOJ|SABRE JET
SNOW|SNOWMOBILE (UNLISTED MNF)
SOLE|SOLECTRIA
SOVA|SOVAM
SOWI|SOUTHWIND MOTOR HOME
SPAA|SPACE MOTOR HOME
SPEC|SPECIAL-GO/GULF-CART,DUNE
SPNR|DAIMLERCHRYSLER SPRINTER
SPPI|SPEEDWAY PRODUCTS
SPTN|SPARTAN
SRCO|SEARS
STAN|STANDARD
STAO|STARCRAFT
STAR|STAR
STCO|STARCRAFT (SNOWMOBILE)
STER|STERLING INDUSTRIAL
STEW|STEWART ENGINEERING & EQU
STEY|STEYR-PUCH
STLG|STERLING
STOU|STOUGHTON TRAILERS, INC.
STRA|STRALE
STRG|FREIGHTLINER, STERLING DI
STRI|STRICK TRAILERS
STRM|STREAMLINE MOTOR HOME
STRN|SATURN
STU|STUDEBAKER
STUZ|STUTZ
SUBA|SUBARU
SUNB|SUNBEAM
SUPT|SUPER TWO
SUTP|STUPHEN
SUZI|SUZUKI
SUZU|SUZULIGHT SU
SWGR|SWINGER SNOWMOBILES
SYRE|SYRENA
TAMA|TAMA
TATR|TATRA
TAUN|TAUNUS (GERMAN FORD)
TCHA|TCHAIKA
THAM|THAMES
THMS|THOMAS BUILT BUS COMPANY
TIMP|TIMPTE, INC.
TITA|TITAN TRAILER
TITN|TITAN CUSTOM MOTORCYCLE
TJAA|TJAARDA
TOLO|TOUR-A-LODGE
TORN|TORNADO (BRITISH)
TORO|TORO
TOYP|TOYOPET
TOYT|TOYOTA
TRAB|TRABANT
TRAN|TRANSTAR
TRAO|TRANSCRAFT CORP (TRAILER)
TRAV|TRAVOY MOTOR HOME
TRIM|TRAILMOBILE
TRIU|TRIUMPH
TRLK|TRAIL KING INDUSTRIES
TRMI|TRAVELER MFG
TROJ|TROJAN
TRPE|TERRAPLANE
TRUM|TRIUMPH (MOTORCYCLE)
TRVC|TRAVCO CORP
TRVL|TRAVEL HOME
TRVM|TRAVELINER MOTOR HOME
TSCC|TUCKER SNO-CAT(SNOWMOBILE
TTII|T & T INDUSTRIES
TUCK|TUCKER
TURN|TURNER
TVR|TVR
TZ|TZ
UAZ|UAZ
UNIC|UNICAR
UNIP|UNIPOWER
UNKN|UNKNOWN
USEL|U.S. ELECTRICAR
USSM|U.S. SUZUKI MOTOR CORP.,
UTIL|UTILITY TRAILER MFG. CO.
UTIM|UTILIMASTER
VACR|VECTOR AEROMOTIVE
VAL|VAL
VALK|VALKRIE
VANG|VANGUARD
VANT|VANETTE
VAUX|VAUXHALL
VEAM|VEHICULOS AUTOMORES MEXAC
VERI|VERITAS
VESP|VESPA
VKNG|VIKING SNOWMOBILES, INC.
VNDN|VANDEN PLAS
VOGA|VOLGA
VOLK|VOLKSWAGEN
VOLV|VOLVO
WAGN|WAGNER
WALA|WARD LAFRANCE
WALT|WALTER MOTOR TRUCK
WANC|WABASH NATIONAL CORP
WARS|WARSZAWA
WART|WARTBURG
WARW|WARWICK
WATF|WATFORD
WEND|WENDAX
WERG|WENGER MFG. (TL)
WHGM|WHITEGMC
WHIA|WHITE STAR
WHIP|WHIPPET
WHIT|WHITE MOTOR CORP.
WILS|WILSON
WINN|WINNEBAGO
WIPT|WHIP IT SNOWMOBILES
WLLS|WILLYS
WOLS|WOLSELEY
WOOD|WOODILL WILDFIRE
WORT|WORTHINGTON CHAMP
WRKH|WORKHORSE CUSTOM CHASSIS
WSTR|WESTERN STAR
YALE|YALE, MATERIAL HANDLING D
YAMA|YAMAHA
YENK|YENKO
YLN|YLN (YUE LOONG MOTOR CO.)
YMCL|YAMAHA (SNOWMOBILE)
YMTI|YAMATI MOTORCYCLES
ZAPO|ZAPOROZHETS
ZARC|ZAR CAR
ZCZY|ZASTAVIA MADE IN YOGOSLAV
ZETA|ZETA
ZIL|ZIL
ZIM|ZIM
ZIMR|ZIMMERMAN AUTOMOBILES
ZMCC|ZIMMER
ZUND|ZUNDAPP
ZWIC|ZWICKAU
